####################
#                  #
#                  #
#         X        #
#        ###       #
#                  #
#                  #
#   P      B       #
####################