########################
#P                     #
#                      #
#   B       G          #
#  ###      #          #
#           #      X   #
#           #     ###  #
#           #          #
#           #          #
########################