########################
#                      #
#                      #
#                X     #
#               ###    #
#                      #
#         H            #
#        ###           #
#                      #
#   P     B            #
########################